@
size =
27
16
@
jump =
0
@s
@1






..... ............... .....
...........G...............
..S.....................E..
...........................
..... ............... .....
           .......
           ...G...
           .......
           .......

@2
B





WWWWW WWWWWWWWWWWWWWW WWWWW
W   WWZL            RWW   W
W $  D               D  $ W
W   WWWK            WWW   W
WWWWW WWWWWRWWdWWWWWW WWWWW
           W     W
           W  E  W
           W     W
           WWWWWWW

@3








  P                     P







@4
200000000000000000000000000
000000000000000000000000000
000000000000000000000000000
000000000000000000000000000
000000000000000000000000000
000000000000000000000000000
000000000000000000000000000
000000020000000000003000000
000000000000000000000100000
000000000000000000000000000
000000000001003000000000000
000000000000000000000000000
000000000000000000000000000
000000000000000000000000000
000000000000000000000000000
000000000000000000000000000
