WWWWWWW WWWWWWW
WSW.W.W W.W.W.W
WWW.W.W W.W.W.W
W.....W W.....W
W.W.WWW W.W.WWW
W.W.W.W W.W.W.W
WWW.W.W WWW.W.W
W.W...W W.W...W
W.W.W.W W.W.WEW
WWWWWWW WWWWWWW

@
jump =
8
@