WWW.WWW
WSW.W.W
WWW.W.W
W.W.W.W
W.W.W.W
W.W.W.W
WWW.W.W
W.W.W.W
W.W.WEW
WWW.WWW

jump =
4