@
size =
23
9
@
jump =
0
@s
@1
.......  .......  
.......  .......  
...G...  ...G...
.......  .......  
.......  .......  .....
.......................
....................E..
...S...................
.......  .......  .....
@2
WTTTTTW  WTTTTTW
W     W  W     W  
W     W  W  K  W
W     W  W     W  
W     W  W     W  WWWWW
W     WWWW  B  WWWW   W
W     D  D     D  D $ W
W  $  WWWW     WWWW   W
WWWWWWW  WWWWWWW  WWWWW
@3
00000000000000000000000
00000000000000000000000
00000000000000000000000
00000000000000000000000
00000000000000000000000
00000000000000000000000
00000000000000000000P00
000P0000000000000000000
00000000000000000000000
@4
00000000000000000000000
00000000000000000000000
00000000000000000000000
00000000000000000000000
00000000000000000000000
00000000000020000000000
00000010010000020020000
00000000000000000000000
00000000000000000000000