@
size =
15
10
@
jump =
8
@s
@1
....... .......
.S..... .......
...............
...............
...............
....... .......
....... .......
....... .......
....... ...E...
....... .......
@2
WWWZWWW WWWWWWW
W BLB W W     W
WBK   WWWWDW  W
ZLK        D  W
W     WWWWDW  W
W WDW W W     W
W     W W     W
W     W W     W
W     W W     W
WWWRWWW WWWWWWW
@3
000000000000000
000000000000000
000000000000000
000000000000000
000000000000000
000000000000000
000000000000000
000000000000000
000000000000000
000000000000000
@4
000000000000000
001130000000000
020000000040000
020000000000000
000000000040000
000300000000000
000000000000000
000000000000000
000000000000000
000400000000000