@
size =
23
9
@
jump =
0
@s
@1
.......  .......  
.......  .......  
...G...  ...G...
.......  .......  
.......  .......  .....
.......................
..S.................E..
.......................
.......  .......  .....
@2
WWTTTWW  WWTTTWW
W     W  W     W  
W     W  W  K  W
W     W  W     W  
W     W  W     W  WWWWW
W  Q  WWWW  B  WWWW   W
W $   D  D     D  D $ W
W     WWWW     WWWW   W
WWWWWWW  WWWWWWW  WWWWW
@3
00000000000000000000000
00000000000000000000000
00000000000000000000000
00000000000000000000000
00000000000000000000000
00000000000000000000000
00P00000000000000000P00
00000000000000000000000
00000000000000000000000
@4
00000000000000000000000
00000000000000000000000
00000000000000000000000
00000000000000000000000
00000000000000000000000
00000000000020000000000
00000010010000020020000
00000000000000000000000
00000000000000000000000