@
size =
41
10
@
jump =
21
@s

WWWWWWWWWWWWWWWWWWWW WWWWWWWWWWWWWWWWWWWW
WS..W....W.........W W.W....W......W....W
WWWWWWWWWWWWWWWWWW.W W.WWWWWWWWWWWWWWWW.W
W............W.....W W.....W............W
W.WWWWWWWWWWWWWWWWWW W.WWWWWWWWWWWWWWWWWW
W.......W..........W W.............W....W
WWWWWWWWWWWWWWWWWW.W W.WWWWWWWWWWWWWWWW.W
W....W.......W.....W W..W....W..........W
W....W.......W.....W WE.W....W..........W
WWWWWWWWWWWWWWWWWWWW WWWWWWWWWWWWWWWWWWWW