@
size =
15
10
@
jump =
8
@s
@1
....... .......
.S..... .......
...............
...............
...............
....... .......
....... .......
....... .......
....... ...E...
....... .......
@2
WWWZWWW WWWWWWW
W BL  W W     W
WBK   WWW  W  W
ZL         D  W
W     WWW  W  W
W WDW W W     W
W     W W     W
W     W W     W
W  L  W W     W
WWWZWWW WWWWWWW
@3
000000000000000
000000000000000
000000000000000
000000000000000
000000000000000
000000000000000
000000000000000
000000000000000
000000000000000
000000000000000
@4
000000000000000
001100000000000
020000000000000
020000000000000
000000000000000
000000000000000
000000000000000
000000000000000
000000000000000
000000000000000