@
size =
23
8
@
jump =
0
@s
@1
        .....          
        .....          
        .....          
..... ........... .....
.......................
..S.................E..
.......................
..... ........... .....
@2
        WWWWW
        W K W          
        W   W          
WWWWW WWWWDWWWWWW WWWWW
W   WWW         WWW   W
W $  D   B K BB D D $ W
W   WWW         WWW   W
WWWWW WWWWWWWWWWW WWWWW
@3
00000000000000000000000
00000000000000000000000
00000000000000000000000
00000000000000000000000
00000000000000000000000
00P00000000000000000P00
00000000000000000000000
00000000000000000000000
@4
00000000000000000000000
00000000000000000000000
00000000000000000000000
00000000001000000000000
00000000000000000000000
00000000010002302030000
00000000000000000000000
00000000000000000000000